5 5
1 7 7 2 1
4 6 7 3 1
2 5 6 9 1
6 3 2 5 1
4 4 1 6 1